................................
..*****.......****.......*****..
..*****.......****.......*****..
..****************************..
..****************************..
..****************************..
...**************************...
....************************....
.....**********************.....
......********************......
.......******************.......
........****************........
********************************
********************************
********************************
********************************
********************************
********************************
********************************
********************************
********************************
........****************........
.......******************.......
......********************......
.....**********************.....
....************************....
...**************************...
..****************************..
..****************************..
..*****.......****.......*****..
..*****.......****.......*****..
................................