..............*..*........****..
.*..*....................******.
.*................****.....*****
.............######.****.....**.
..*..........######.............
...........**........*........*.
................................
..*....*.............*.......*..
......##..*...#@#...**..##....**
......%%................%%......
*.....%%....*...........%%......
..*...###%####....####%###......
*.....###%####..-.@>!:%###......
................................
**..........*..........*........
~~#%.#~~~~~~~#%.%.#~~~~~~~#.%#~~
~~#.%#~~~~~~~#.%.%#~~~~~~~#%.#~~
.......*.............*........**
**..............................
......########....########......
.*....########....########......
......%%....*...........%%......
..*...%%.*............*.%%......
......##.....*.....*....##......
..*...................*.......*.
......*..*.....................*
**.................**...........
.............######...........**
.**.....****.######..**....***..
*****.....****..................
.******....................****.
..****........*..*...**......**.