%%%%%%%%%%%%%%....%%%%%%%%%%%%%%
%..............................%
%..............................%
%..............................%
%...%%%%%%%%%%....%%%%%%%%%%...%
%..............................%
%..............................%
%..............................%
%...%%%%%%%%%%....%%%%%%%%%%...%
%..............................%
%..............................%
%..............................%
%...%%%%%%%%%%....%%%%%%%%%%...%
%..............................%
%..............................%
%.............%%%%.............%
%.............%%%%.............%
%..............................%
%..............................%
%...%%%%%%%%%%....%%%%%%%%%%...%
%..............................%
%..............................%
%..............................%
%...%%%%%%%%%%....%%%%%%%%%%...%
%..............................%
%..............................%
%..............................%
%...%%%%%%%%%%....%%%%%%%%%%...%
%..............................%
%..............................%
%..............................%
%%%%%%%%%%%%%%....%%%%%%%%%%%%%%