--------------....--------------
-..............................-
-..............................-
-..............................-
-..............................-
-.......----------------.......-
-........--...---....--........-
-........--...---....--........-
-.....--------------------.....-
-..............................-
-..............................-
-..............................-
-.....-----..........-----.....-
-.....-----..........-----.....-
-..............................-
-..............................-
-..............................-
-..............................-
-.....-----..........-----.....-
-.....-----..........-----.....-
-..............................-
-..............................-
-..............................-
-.....--------------------.....-
-........--...---....--........-
-........--...---....--........-
-.......----------------.......-
-..............................-
-..............................-
-..............................-
-..............................-
--------------....--------------