................................
................................
.....----.......................
...................---..........
.....................---........
....----...............--.......
................................
..............---...............
................................
.......................--.......
..................---...........
................................
......--........................
.............---........----....
...........---........---.......
................................
---====----====----====----====-
................................
.....----.......................
...................---..........
.....................---........
....----...............--.......
................................
..............---...............
................................
.......................--.......
..................---...........
................................
......--........................
.............---........----....
...........---........---.......
................................
