~~~~~~~~~..............~~~~~~~~~
~~~~~~~~................~~~~~~~~
~~~~~~~..................~~~~~~~
~~~~~~~..................~~~~~~~
~~~~~~~..................~~~~~~~
~~~~~~~~................~~~~~~~~
~~~~~~~~~..............~~~~~~~~~
~~~~~~~~~~............~~~~~~~~~~
~~~~~~~~~..............~~~~~~~~~
~~~~~~~~................~~~~~~~~
~~~~~~~..................~~~~~~~
~~~~~~....................~~~~~~
................................
................................
.............******.............
.............******.............
.............******.............
.............******.............
................................
................................
~~~~~~....................~~~~~~
~~~~~~~..................~~~~~~~
~~~~~~~~................~~~~~~~~
~~~~~~~~~..............~~~~~~~~~
~~~~~~~~~~............~~~~~~~~~~
~~~~~~~~~..............~~~~~~~~~
~~~~~~~~................~~~~~~~~
~~~~~~~..................~~~~~~~
~~~~~~~..................~~~~~~~
~~~~~~~..................~~~~~~~
~~~~~~~~................~~~~~~~~
~~~~~~~~~..............~~~~~~~~~