~~~~~~~~~~~~~~~~~~~~~~~~~~~~~~~~
~                              ~
~                              ~
~                              ~
~                              ~
~ ###                     %%%%%~
~     *                  *     ~
~      *       %%       *      ~
~       *      %%      *       ~
~        *            *        ~
~  %%%%   *          *   %%%%  ~
~          *        *          ~
~           ********           ~
~           *######*           ~
~     ***    ~                 ~
~     *#*    ~          ***    ~
~     ***         ~     *#*    ~
~                 ~     ***    ~
~           *######*           ~
~           ********           ~
~          *        *          ~
~  %%%%   *          *   %%%%  ~
~        *            *        ~
~       *      %%      *       ~
~      *       %%       *      ~
~     *                  *     ~
~%%%%%                     ### ~
~                              ~
~                              ~
~                              ~
~                              ~
~~~~~~~~~~~~~~~~~~~~~~~~~~~~~~~~