~~~~~~~~~~............~~~~~~~~~~
~~~~~~~~~...*....**....~~~~~~~~~
~~~~~~~~.....*....**....~~~~~~~~
~~~~~~~..................~~~~~~~
~~~~~~.....***............~~~~~~
~~~~~....***.....%%%%%.....~~~~~
~~~~......**.....%%%%%......~~~~
~~~....**.....%....%.....**..~~~
~~....*.*.....%....%.....**...~~
~...*.........%%%%%%...........~
.*.*....%.............%%.%%%%%..
...*....%.............%%.....%..
........%...x.x..x.x..%%.....%..
.%%%%%%%%.............###%%%##..
................................
---====--===--====--===--====---
---====--===--====--===--====---
................................
.##%%%###..............%%%%%%%%.
.%.....%%...+.+..+.+...%........
.%.....%%..............%........
.%%.%%%%%..............%........
~..........------..............~
~~.........%....%.....*.*.....~~
~~~........%....%............~~~
~~~~.....=====.......*......~~~~
~~~~~....=====......***....~~~~~
~~~~~~.........+++...**...~~~~~~
~~~~~~~........+++.......~~~~~~~
~~~~~~~~................~~~~~~~~
~~~~~~~~~..............~~~~~~~~~
~~~~~~~~~~............~~~~~~~~~~