~~~~~~~~~~~~~~#..#~~~~~~~~~~~~~~
~..............................~
~..............................~
~..............................~
~..............................~
~.###.....................%%%%%~
~.....*..................*.....~
~......*.......%%.......*......~
~.......*......%%......*.......~
~........*............*........~
~..%%%%...*..........*...%%%%..~
~..........*........*..........~
~...........********...........~
~...........*######*...........~
~.....***....~.................~
~.....*#*....~..........***....~
~.....***.........~.....*#*....~
~.................~.....***....~
~...........*######*...........~
~...........********...........~
~..........*........*..........~
~..%%%%...*..........*...%%%%..~
~........*............*........~
~.......*......%%......*.......~
~......*.......%%.......*......~
~.....*..................*.....~
~%%%%%.....................###.~
~..............................~
~..............................~
~..............................~
~..............................~
~~~~~~~~~~~~~~#..#~~~~~~~~~~~~~~