.*....*....*..*..*.....*..*..*..
**.................*..........*.
.*.................*....*.....*.
###%%%#######.........*....*....
###%%%#######......*..*...*.....
...........##..x.............*.~
...........%%.....x...*....*.*~~
#######....##...........*.*..~~~
#######....##.*..........*..~~~.
.*...*.......*..*..........~~~..
...*.........*.........*..*~~~..
.*.*.........*.*..........~~~...
.*..*..*......*........*..~~~...
####....*.................~~~...
####....*..............*..~~~###
x...................%....#######
..................%..........*.*
x........####.###*.............*
###%%########.###..*..###......*
..*..*....*...*..*....~~~......*
.*...*...*.*..*...*..~~~....*...
.......*..*...*..*.~~~~.......*.
.*.*..**....*....~~~~.........*.
....*....*...~~~~~~~.........*..
.*.*.....~~~~~~~~~..........*...
..*.~~~~~~~~~~~..........*...*..
~~~~~~~~~~~~....................
~~~~~~~~~~...*...........*..*.*.
~~~~~~~......*.......#####%%####
....*.......*........#####%%####
.......*..*.......*..*...*......
....*..*......*..*.....*....*...